4 13 31
###############################
#p    * **    *   *           #
# # # #*# # # # # # # # # # # #
#      ** * *  *   * ** 3 *   #
# # # # # #*# # # # # # #*# # #
#*   * *    *b* *   **    2   #
#2# # # # # # # # # # # # #*# #
#    *     *        *    **  3#
#*#*#*# #*#*#*#*# # #1# # #*# #
#    3   *   *2*    *   *     #
#*# # # # # # # # # # #*# # #*#
#x*    * **    ** ***     1   #
###############################