1 13 31
###############################
#p  f  *f *  1 *   *  * * *   #
# # # #*# # #*#*# # # #*#*#*# #
#   *     ***  *      *   * * #
# # # # # #*# # #*#*# # # # #*#
#s    s      **  *  *   1     #
# # # # # # # # # #*# #*# # # #
#*  *      *  *      *        #
# # # # #*# # # #*#*# # # # # #
#*    **  *       *      1    #
# #*# # # # # # #*# # # # # # #
#   1       *   *  *     q    #
###############################