4 13 31
###############################
#p    * **    *   3           #
# # # #*# # # # # # # # # # # #
#      ** * *  *   * ** 3 *   #
# # # # # #*# # # # # # #*# # #
#*   * *    *b* *   **  3     #
#3# # # # # # # # # # # # #*# #
#    *     *        *    **  3#
# #*# # #*#*#*#*# # #1# # #*# #
#    3   *   *2*    *   *     #
#*# # # # # # # # # # #*# # #*#
#x*    * **    ** ***     1   #
###############################