5 13 31
###############################
#p * *3   5   *  ** * *      *#
# # # # #*# # #*# # # # # #*# #
#    * * *** **  3  *    **   #
# #*# # # # # # #b#1# # # # #*#
#          *     **      *  **#
# # #*# # # # # #*#*#*#*# # # #
#   *        *   *3*x* *      #
# # # # #*# # # # # # #*# #*# #
#   ****         *2           #
# # # # # # # # # #*# # # # #*#
#  ** *3  *    2      5       #
###############################